Dd, Dd, Dd, Dd, Dd, Dd, Dd, Dd, Dd, Dd, Dd, Dd, Dd, Dd, Dd, Dd, Dd, Dd, Dd, Dd, Dd, Dd, Dd, Dd, Dd, Dd, Dd, Dd, Dd, Dd, Dd, Dd, Dd, Dd, Dd, Dd, Dd, Dd, Dd, Dd
Dd, Dd, Dd, Dd, Dd, Dd, Dd, Dd, Dd, Dd, Dd, Dd, Dd, Dd, Dd, Dd, Dd, Dd, Dd, Dd, Dd, Dd, Dd, Dd, Dd, Dd, Dd, Dd, Dd, Dd, Dd, Dd, Dd, Dd, Dd, Dd, Dd, Dd, Dd, Dd
Dd, Dd, Dd, Dd, Dd, Dd, Dd, Dd, Dd, Dd, Dd, Dd, Dd, Dd, Dd, Dd, Dd, Dd, Dd, Dd, Dd, Dd, Dd, Dd, Dd, Dd, Dd, Dd, Dd, Dd, Dd, Dd, Dd, Dd, Dd, Dd, Dd, Dd, Dd, Dd
Dd, Dd, Dd, Dd, Dd, Dd, Dd, Dd, Dd, Dd, Dd, Dd, Dd, Dd, Dd, Dd, Dd, Dd, Dd, Dd, Dd, Dd, Dd, Dd, Dd, Dd, Dd, Dd, Dd, Dd, Dd, Dd, Dd, Dd, Dd, Dd, Dd, Dd, Dd, Dd
Dd, Dd, Dd, Dd, Dd, Dd, Dd, Dd, Dd, Dd, Dd, Dd, Dd, Dd, Dd, Dd, Dd, Dd, Dd, Dd, Dd, Dd, Dd, Dd, Dd, Dd, Dd, Dd, Dd, Dd, Dd, Dd, Dd, Dd, Dd, Dd, Dd, Dd, Dd, Dd
Dd, Dd, Dd, Dd, Dd, Dd, Dd, Dd, Dd, Dd, Dd, Dd, Dd, Dd, Dd, Dd, Dd, Dd, Xu, Dd, Xu, Dd, Xu, Dd, Dd, Dd, Dd, Dd, Dd, Dd, Dd, Dd, Dd, Dd, Dd, Dd, Dd, Dd, Dd, Dd
Dd, Dd, Dd, Dd, Dd, Dd, Dd, Dd, Dd, Dd, Xu, Xu, Xu, Dd, Dd, Dd, Xu, Xu, Wog, Xu, Ww^Ewl, Xu, Wog, Xu, Xu, Dd, Dd, Dd, Xu, Xu, Xu, Dd, Dd, Dd, Dd, Dd, Dd, Dd, Dd, Dd
Dd, Dd, Dd, Dd, Dd, Dd, Dd, Dd, Dd, Xu, Wog, Wog, Wwrt, Xu, Xu^_s, Xu^_s, Ww^Ewl, Wog, Wwrt, Wwrt, Ww^Ewl, Wwrt, Wwrt, Wog, Ww^Ewl, Xu^_s, Xu^_s, Xu, Wog, Wwr, Wwr, Xu, Dd, Dd, Dd, Dd, Dd, Dd, Dd, Dd
Dd, Dd, Dd, Dd, Dd, Dd, Dd, Dd, Dd, Wwrt^_s, Wwrt^_s, Wog, Qxu^_s, Qxu^_s, Ww^Ewl, Ww^Ewl, Wog, Wog, Wwrt, Wwrt, Wwrt, Wwrt, Wwrt, Wog, Wog, Ww^Ewl, Ww^Ewl, Qxu^_s, Qxu^_s, Wwr, Wwrt^_s, Wwrt^_s, Dd, Dd, Dd, Dd, Dd, Dd, Dd, Dd
Dd, Dd, Dd, Dd, Dd, Dd, Xu, Xu, Xu, Qxu^_s, Qxu^_s, Qxu^_s, Qxu^_s, Qxu^_s, Wwrt^_s, Ww^Ewl, Wog, Wwrt, Wwrt, Ww^Ewl, Wwrt, Ww^Ewl, Wwrt, Wwrt, Wog, Ww^Ewl, Wwrt^_s, Qxu^_s, Qxu^_s, Qxu^_s, Qxu^_s, Qxu^_s, Xu, Xu, Xu, Dd, Dd, Dd, Dd, Dd
Dd, Dd, Dd, Dd, Dd, Xu, Wog, Wog, Wwrt, Xu, Qxu^_s, Xu, Qxu^_s, Qxu^_s, Wog, Qxu^_s, Qxu^_s, Qxu^_s, Qxu^_s, Xu, Xu, Xu, Qxu^_s, Qxu^_s, Qxu^_s, Qxu^_s, Wog, Qxu^_s, Qxu^_s, Xu, Qxu^_s, Xu, Wog, Wwr, Wwr, Xu, Dd, Dd, Dd, Dd
Dd, Dd, Dd, Dd, Dd, Xu, Wog, Ai, Wwrt, Xu, Qxu^_s, Uu, Qxu^_s, Qxu^_s, Wog, Ww^Ewl, Wog, Wwrt, Wwrt, Xv^_s, Xv^_s, Xv^_s, Wwrt, Wwrt, Wog, Ww^Ewl, Wog, Qxu^_s, Qxu^_s, Uu, Qxu^_s, Xu, Wog, Ai, Wwr, Xu, Dd, Dd, Dd, Dd
Dd, Dd, Dd, Dd, Dd, Qxu^_s, Qxu^_s, Wog, Qxu^_s, Qxu^_s, Qxu^_s, Uu, Qxu^_s, Qxu^_s, Wog, Ww^Ewl, Wog, Wwrt, Ww^Ewl, Wwrt, Xv^_s, Wwrt, Ww^Ewl, Wwrt, Wog, Ww^Ewl, Wog, Qxu^_s, Qxu^_s, Uu, Qxu^_s, Qxu^_s, Qxu^_s, Wwr, Qxu^_s, Qxu^_s, Dd, Dd, Dd, Dd
Dd, Dd, Dd, Dd, Dd, Dd, Dd, Qxu^_s, Qxu^_s, Qxu^_s, Xu, Xu, Qxu^_s, Qxu^_s, Qxu^_s, Qxu^_s, Qxu^_s, Qxu^_s, Xv^_s, Xv^_s, Wwrt, Xv^_s, Xv^_s, Qxu^_s, Qxu^_s, Qxu^_s, Qxu^_s, Qxu^_s, Qxu^_s, Xu, Xu, Qxu^_s, Qxu^_s, Qxu^_s, Dd, Dd, Dd, Dd, Dd, Dd
Dd, Dd, Dd, Dd, Dd, Dd, Dd, Xu, Qxu^_s, Qxu^_s, Qxu^_s, Xu, Qxu^_s, Qxu^_s, Wog, Wwrt, Wog, Wwrt, Xv^_s, Wwrt, Ai, Wwrt, Xv^_s, Wwrt, Wog, Wwrt, Wog, Qxu^_s, Qxu^_s, Xu, Qxu^_s, Qxu^_s, Qxu^_s, Xu, Dd, Dd, Dd, Dd, Dd, Dd
Dd, Dd, Dd, Dd, Dd, Dd, Dd, Uu, Qxu^_s, Qxu^_s, Qxu^_s, Qxu^_s, Xu, Qxu^_s, Wog, Wwrt, Wog, Wwrt, Xv^_s, Wwrt, Wwrt, Wwrt, Xv^_s, Wwrt, Wog, Wwrt, Wog, Qxu^_s, Xu, Qxu^_s, Qxu^_s, Qxu^_s, Qxu^_s, Uu, Dd, Dd, Dd, Dd, Dd, Dd
Dd, Dd, Dd, Dd, Dd, Dd, Qxu^_s, Rra, Qxu^_s, Qxu^_s, Qxu^_s, Qxu^_s, Uu, Qxu^_s, Qxu^_s, Qxu^_s, Qxu^_s, Qxu^_s, Qxu^_s, Xv^_s, Xv^_s, Xv^_s, Qxu^_s, Qxu^_s, Qxu^_s, Qxu^_s, Qxu^_s, Qxu^_s, Uu, Qxu^_s, Qxu^_s, Qxu^_s, Qxu^_s, Rra, Qxu^_s, Dd, Dd, Dd, Dd, Dd
Dd, Dd, Dd, Dd, Dd, Dd, Xu, Rra, Xu, Qxu^_s, Qxu^_s, Xu, Uu, Qxu^_s, Wog, Wwrt, Wog, Wwrt, Wwrt, Xv^_s, Uu, Xv^_s, Wwrt, Wwrt, Wog, Wwrt, Wog, Qxu^_s, Uu, Xu, Qxu^_s, Qxu^_s, Xu, Rra, Xu, Dd, Dd, Dd, Dd, Dd
Dd, Dd, Dd, Dd, Dd, Dd, Xu, Uu, Uu, Qxu^_s, Xu, Uu, Uu, Qxu^_s, Wog, Wwrt, Wog, Wwrt, Ww^Ewl, Xv^_s, Uu, Xv^_s, Ww^Ewl, Wwrt, Wog, Wwrt, Wog, Qxu^_s, Uu, Uu, Xu, Qxu^_s, Uu, Uu, Xu, Dd, Dd, Dd, Dd, Dd
Dd, Dd, Dd, Dd, Dd, Dd, Qxu^_s, Qxu^_s, Uu, Qxu^_s, Qxu^_s, Qxu^_s, Xu, Qxu^_s, Qxu^_s, Xu, Xu, Xu, Qxu^_s, Qxu^_s, Uu, Qxu^_s, Qxu^_s, Xu, Xu, Xu, Qxu^_s, Qxu^_s, Xu, Qxu^_s, Qxu^_s, Qxu^_s, Uu, Qxu^_s, Qxu^_s, Dd, Dd, Dd, Dd, Dd
Dd, Dd, Dd, Dd, Dd, Uu, Qxu^_s, Qxu^_s, Xu, Qxu^_s, Qxu^_s, Qxu^_s, Qxu^_s, Qxu^_s, Uu, Qxu^_s, Uu, Qxu^_s, Qxu^_s, Qxu^_s, Rra, Qxu^_s, Qxu^_s, Qxu^_s, Uu, Qxu^_s, Uu, Qxu^_s, Qxu^_s, Qxu^_s, Qxu^_s, Qxu^_s, Xu, Qxu^_s, Qxu^_s, Uu, Dd, Dd, Dd, Dd
Dd, Dd, Dd, Dd, Dd, Uu, Dd, Dd, Dd, Dd, Dd, Xu, Xv^_s, Uu, Xv^_s, Uu, Rra, Xu, Xv^_s, Xu, Rra, Xu, Xv^_s, Xu, Rra, Uu, Xv^_s, Uu, Xv^_s, Xu, Dd, Dd, Dd, Dd, Dd, Uu, Dd, Dd, Dd, Dd
Dd, Dd, Dd, Dd, Dd, Dd, Dd, Dd, Dd, Dd, Dd, Dd, Dd, Xv^_s, Dd, Xv^_s, Xv^_s, Rra, Uu, Uu, Rra, Uu, Uu, Rra, Xv^_s, Xv^_s, Dd, Xv^_s, Dd, Dd, Dd, Dd, Dd, Dd, Dd, Dd, Dd, Dd, Dd, Dd
Dd, Dd, Dd, Dd, Dd, Dd, Dd, Dd, Dd, Dd, Dd, Dd, Dd, Dd, Dd, Dd, Dd, Xv^_s, Uu, Uu, Uu, Uu, Uu, Xv^_s, Dd, Dd, Dd, Dd, Dd, Dd, Dd, Dd, Dd, Dd, Dd, Dd, Dd, Dd, Dd, Dd
Dd, Dd, Dd, Dd, Dd, Dd, Dd, Dd, Dd, Dd, Dd, Dd, Dd, Dd, Dd, Dd, Dd, Uu, Uu, Xv^_s, Xv^_s, Xv^_s, Uu, Uu, Dd, Dd, Dd, Dd, Dd, Dd, Dd, Dd, Dd, Dd, Dd, Dd, Dd, Dd, Dd, Dd
Dd, Dd, Dd, Dd, Dd, Dd, Dd, Dd, Dd, Dd, Dd, Dd, Dd, Dd, Dd, Dd, Dd, Dd, Dd, Dd, Dd, Dd, Dd, Dd, Dd, Dd, Dd, Dd, Dd, Dd, Dd, Dd, Dd, Dd, Dd, Dd, Dd, Dd, Dd, Dd
Dd, Dd, Dd, Dd, Dd, Dd, Dd, Dd, Dd, Dd, Dd, Dd, Dd, Dd, Dd, Dd, Dd, Dd, Dd, Dd, Dd, Dd, Dd, Dd, Dd, Dd, Dd, Dd, Dd, Dd, Dd, Dd, Dd, Dd, Dd, Dd, Dd, Dd, Dd, Dd
Dd, Dd, Dd, Dd, Dd, Dd, Dd, Dd, Dd, Dd, Dd, Dd, Dd, Dd, Dd, Dd, Dd, Dd, Dd, Dd, Dd, Dd, Dd, Dd, Dd, Dd, Dd, Dd, Dd, Dd, Dd, Dd, Dd, Dd, Dd, Dd, Dd, Dd, Dd, Dd
Dd, Dd, Dd, Dd, Dd, Dd, Dd, Dd, Dd, Dd, Dd, Dd, Dd, Dd, Dd, Dd, Dd, Dd, Dd, Dd, Dd, Dd, Dd, Dd, Dd, Dd, Dd, Dd, Dd, Dd, Dd, Dd, Dd, Dd, Dd, Dd, Dd, Dd, Dd, Dd
Dd, Dd, Dd, Dd, Dd, Dd, Dd, Dd, Dd, Dd, Dd, Dd, Dd, Dd, Dd, Dd, Dd, Dd, Dd, Dd, Dd, Dd, Dd, Dd, Dd, Dd, Dd, Dd, Dd, Dd, Dd, Dd, Dd, Dd, Dd, Dd, Dd, Dd, Dd, Dd
